安庆=AQG#Anqing
阿克苏=AKU#Aksu
阿勒泰=AAT#Altay
安康=AKA#Ankang
北京=PEK#Beijing
包头=BAV#Baotou
北海=BHY#Beihai
保山=BSD#Baoshan
百色=AEB#Baise
成都=CTU#Chengdu
重庆=CKG#Chongqing
长沙=CSX#Changsha
长春=CGQ#Changchun
常州=CZX#Changzhou
长治=CIH#Changzhi
赤峰=CIF#Chifeng
常德=CGD#Changde
长白山=NBS#Changbaishan
朝阳市=CHG#Chaoyang
昌都=BPX#Changdu
大连=DLC#Dalian
迪庆(香格里拉)=DIG#xianggelila
大理=DLU#Dali
大同=DAT#Datong
丹东=DDG#Dandong
敦煌=DNH#Dunhuang
大庆=DQA#Daqing
东营=DOY#Dongying
达县=DAX#Daxian
恩施=ENH#Enshi
鄂尔多斯=DSN#Ordos
福州=FOC#Fuzhou
佛山=FUO#Foshan
阜阳=FUG#Fuyang
广州=CAN#Guangzhou
桂林=KWL#Guilin
贵阳=KWE#Guiyang
赣州=KOW#Ganzhou
格尔木=GOQ#Geermu
广元=GYS#Guangyuan
烟台=HGH#Hangzhou
哈尔滨=HRB#Harbin
海口=HAK#Haikou
呼和浩特=HET#Hohhot
合肥=HFE#Hefei
黄岩=HYN#Huangyan
海拉尔=HLD#Hailaer
黄山=TXN#Huangshan
邯郸=HDG#Handan
黑河=HEK#Heihe
怀化=HJJ#Huaihua
和田=HTN#Hetian
汉中=HZG#Hanzhong
哈密=HMI#Hami
济南=TNA#Jinan
泉州(晋江)=JJN#jinjiang
九寨沟=JZH#Jiuzhaigou
景洪(西双版纳)=JHG#Xishuangbanna
景德镇=JDZ#Jingdezhen
济宁=JNG#Jining
佳木斯=JMU#Jiamusi
锦州=JNZ#Jinzhou
嘉峪关=JGN#Jiayuguan
九江=JIU#Jiujiang
井冈山=JGS#Jinggangshan
昆明=KMG#Kunming
喀什=KHG#Kashi
库尔勒=KRL#Korla
库车=KCA#Kuche
克拉玛依=KRY#Karamay
康定=KGT#kangding
丽江=LJG#Lijiang
兰州=LHW#Lanzhou
拉萨=LXA#Lhasa
临沂=LYI#Linyi
连云港=LYG#Lianyungang
柳州=LZH#Liuzhou
洛阳=LYA#Luoyang
泸州=LZO#Luzhou
临沧=LNJ#Lincang
林芝=LZY#Linzhi
荔波=LLB#Libo
龙岩(连城)=LCX#Liancheng
牡丹江=MDG#Mudanjiang
绵阳=MIG#Mianyang
满洲里=NZH#Manzhouli
芒市=LUM#Mangshi
漠河=OHE#Mohe
梅县=MXZ#Meixian
南京=NKG#Nanjing
宁波=NGB#Ningbo
南宁=NNG#Nanning
南昌=KHN#Nanchang
南通=NTG#Nantong
南平（武夷山）=WUS#Wuyishan
南阳=NNY#Nanyang
南充=NAO#Nanchong
攀枝花=PZI#Panzhihua
青岛=TAO#Qingdao
齐齐哈尔=NDG#Qiqihaer
衢州=JUZ#Quzhou
秦皇岛=SHP#Qinhuangdao
庆阳=IQN#Qingyang
上海=SHA#Shanghai
深圳=SZX#Shenzhen
三亚=SYX#Sanya
沈阳=SHE#Shenyang
石家庄=SJW#Shijiazhuang
汕头=SWA#Shantou
思茅=SYM#Simao
昭通=ZAT#Zhaotong
天津=TSN#Tianjin
太原=TYN#Taiyuan
通辽=TGO#Tongliao
腾冲=TCZ#Tengchong
铜仁=TEN#Tongren
天水=THQ#Tianshui
塔城=TCG#Tacheng
武汉=WUH#Wuhan
温州=WNZ#Wenzhou
无锡=WUX#Wuxi
乌鲁木齐=URC#Urumqi
威海=WEH#Weihai
潍坊=WEF#Weifang
万州=WXN#Wanzhou
乌兰浩特=HLH#Ulanhot
乌海=WUA#Wuhai
梧州=WUZ#Wuzhou
西安=SIA#Xian
厦门=XMN#Xiamen
西宁=XNN#Xining
徐州=XUZ#Xuzhou
襄樊(襄阳)=XFN#Xiangyang
西昌=XIC#Xichang
锡林浩特=XIL#Xilinhot
烟台=YNT#Yantai
银川=INC#Yinchuan
义乌=YIW#Yiwu
宜昌=YIH#Yichang
延吉=YNJ#Yanji
榆林=UYN#Yulin
运城=YCU#Yuncheng
盐城=YNZ#Yancheng
宜宾=YBP#Yibin
延安=ENY#Yanan
伊宁=YIN#Yining
伊春=LDS#Yichun
永州=LLF#Yongzhou
郑州=CGO#Zhengzhou
珠海=ZUH#Zhuhai
张家界=DYG#Zhangjiajie
湛江=ZHA#Zhanjiang
舟山(普陀山)=HSN#putuoshan
中卫=ZHY#Zhongwei
拉斯维加斯=LAS#Las Vegas
巴厘岛=DPS#Bali Island
大阪=OSA#Osaka
旧金山=SFO#San Francisco
圣迭戈=SAN#San Diego
柏林=BER#Berlin
汉堡=HAM#Hamburg
斯德哥尔摩=STO#Stockholm
马尼拉=MNL#Manila
马德里=MAD#Madrid
澳门=MFM#Macau
慕尼黑=MUC#Munich
吉隆坡=KUL#Kuala Lumpur
西雅图=SEA#Seattle
法兰克福=FRA#Frankfurt
洛杉矶=LAX#Los Angeles
温哥华=YVR#Vancouver
迪拜=DXB#Dubai
开罗=CAI#Cairo
台北=TPE#Taipei
迈阿密=MIA#Miami
曼谷=BKK#Bangkok
清迈=CNX#Chiang Mai
苏梅岛=USM#Koh Samui
素叻他尼=URT#Surat Thani
名古屋=NGO#Nagoya
河内=HAN#Hanoi
纽约=NYC#New York
芝加哥=CHI#Chicago
罗马=ROM#Rome
火奴鲁鲁=HNL#Honolulu
赫尔辛基=HEL#Helsinki
首尔=SEL#Seoul
雅加达=JKT#Jakarta
奥兰多=MCO#Orlando
波士顿=BOS#Boston
布鲁塞尔=BRU#Brussels
亚特兰大=ATL#Atlanta
丹佛=DEN#Denver
里昂=LYS#Lyon
苏黎世=ZRH#Zurich
金边=PNH#Phnom Penh
悉尼=SYD#Sydney
东京=TYO#Tokyo
伊斯坦布尔=IST#Istanbul
布里斯班=BNE#Brisbane
底特律=DTT#Detroit
新加坡=SIN#Singapore
达拉斯=DFW#Dallas
米兰=MIL#Milan
普吉=HKT#Phuket
墨尔本=MEL#Melbourne
香港=HKG#Hong Kong
胡志明市=SGN#Ho Chi Minh
巴黎=PAR#Paris
蒙特利尔=YMQ#Montreal
爱丁堡=EDI#Edinburgh
哥本哈根=CPH#Copenhagen
多伦多=YTO#Toronto
阿姆斯特丹=AMS#Amsterdam
尼斯=NCE#Nice
莫斯科=MOW#Moscow
奥克兰=AKL#Auckland
华盛顿=WAS#Washington
伦敦=LON#London
雅典=ATH#Athens
维也纳=VIE#Vienna
约翰内斯堡=JNB#Johannesburg
奥斯陆=OSL#Aosilu
雷克亚未克=PEK#Leikeyaweike
巴塞罗那=BCN#Basailuona
加德满都=KTM#Jiademandu
济州岛=CJU#JIZHOUDAO
台中=RMQ#Taizhong
高雄=KHH#Gaoxiong
甲米=KBV#Jiami
素可泰=THS#Suketai
华欣=HHQ#Huaxin
杜塞尔多夫=DUS#Dusaierduofu
布拉格=PRG#Bulage
布达佩斯=BUD#Budabeisi
日内瓦=GVA#Rinreiwa
圣彼得堡=LED#Shengbidebao
威尼斯=BUD#Weinisi
岘港=DAD#Qigang
芽庄=NHA#Yazhuang



